NO textures/graystone.xpm
SO textures/rsz_skeleton.xpm
WE textures/redbrick.xpm
EA textures/logomiss.xpm

F 255,255,120
C 0,255,255



       111111111111111111111111
        11111111111111111111111111        
        10000000001100000000000011
        10110000011100000000000011
        1001000000000000000N000011
1111111110110000011100000000000011
1000000000110000011101111111111111
11110111101111011100000010001
11110111111111011101010010001
111101     111011101010010001
11110111111111011101010010001
11000000110101011100000000001
1000000000000000110000000001
10000000000000001101010010001
1100000111010101110001111000111
11110111 1110101 101111110001
11111111 1111111 111111111111
